000000000001010000000000000001000000000000000000000100000000
101101101101101101101101101110110101110110110101101101101101
101101101101101101101101101110101101101110101101101101101101
101101101101101110101101101110101101101110110110110110110110
101101101101101110110110110110101101101101101101101101101101
101101101101101110101101101110101101101101101101110110110110
101101101101101111101101101110101101101110110110110101101101
110110110110110110101101101110110110110110110101101101101101
110101101101101110110110101101101101101110101111110111110110
110101101101101101101111101101101101101110101101101110101101
111101101101101110110110110110110110101110110110110110101101
