000000000001010000000000000001000000000000000000000000011001
001001001001001001001001001000000100000000000001001001001001
001001001001001001001001001000001001001001000001001001001001
001001001001001000001001001000001001001001000000000000000000
001001001001001000000000000000001001001001001001001001001001
001001001001001000001001001000001001001001001001000000000000
001001001001001011001001001000001001001000000000000001001001
000000000000000000001001001000000000000000001001001001001001
000001001001001000000000001001001001001000001010000000011000
000001001001001001001100001001001001001000001001001000001001
111001001001001000000000000000000000001000000000000000001001